111111111110000000-
000000000010000000-
011111111110000000-
010000000000000000-
011111110000000000-
000000010000000000-
000000011111110000-
000000000000000000